2 13 31
###############################
#p     *  *   * 4*  *  *x*   *#
#*# # # # # #*# # # # #*# #*# #
#  *   *     *     *     **   #
# #*# # #*# # # # # # # # # #*#
#  5*      *      * 4 *  *  * #
# # # #*# # # #*# # # #*# # # #
#   *   w*   *  **   *     *  #
#*# # # # # # # # #*# #*# #*# #
#*     *   **m*      *  4   * #
# # # # # #*# # # #*# # # # #*#
# **  *   *    3   *       *  #
###############################


