2 13 31
###############################
#p * *2       * 3** * *      *#
# # # # #*# # #*# # # # # #*# #
#    * * *** **      *    **  #
# #*# # # # #1# #s#1# # # # #*#
#  2       *     **      *  **#
# # #*# # # # # #*#*#*#*# # # #
#   *        *   * *x* *   3  #
# # # # #*# # # # # # #*# #*# #
#   ****         *1           #
# # # # # # # # # #*# # # # #*#
#  ** *   *    3              #
###############################


