2 13 31
###############################
#p *      *   * 3*  * * x    *#
# # #*# #*# # #*# # #*# # #*# #
#*     *   * *     *     **   #
# # #*# # # # # # # # # # # #*#
#  2    *  *     ** 4    *  **#
# # #*#*# # # # # # # #*# # # #
#*  *  *s*   *   *   * *   3  #
#*# # # #*# # # # # # #*# #*# #
#*  ** *         *      4     #
# # # # # # # # # #*# # # # #*#
#  ** *   *    3              #
###############################


